Courtyard
12 10
1 1 1 1 1 1 1 1 1 1 1 1
1 0 0 0 0 0 0 0 0 0 1 1
1 1 0 1 1 1 1 1 1 0 0 1
1 0 0 1 0 0 0 0 1 0 1 1
1 1 0 1 0 1 1 0 1 0 0 2
1 0 0 0 0 1 1 0 0 0 0 2
1 1 0 1 0 1 1 0 0 0 1 1
1 0 0 1 0 0 0 0 1 0 0 1
1 1 0 1 1 1 1 1 1 0 1 1
1 0 0 0 0 3 3 0 0 0 0 1
door 2 GuardSpawn 0 4
door 3 Pool 5 0