GuardSpawn
10 10
- 1 1 1 1 1 1 1 1 -
1 1 0 G G G G 0 1 1
1 0 0 0 0 0 0 0 0 1
1 0 0 0 0 0 0 0 0 1
2 0 0 0 1 1 0 0 0 3
2 0 0 0 1 1 0 0 0 3
1 0 0 0 0 0 0 0 0 1
1 0 0 0 0 0 0 0 0 1
1 1 0 0 0 0 0 0 1 1
- 1 1 1 1 1 1 1 1 -
door 2 Courtyard 9 4
door 3 Lobby 0 5