Lobby
15 10
1 1 1 1 1 1 1 1 1 1 1 1 1 1 1
1 0 A 1 0 0 0 0 0 1 1 0 0 0 1
1 0 0 1 0 0 0 0 0 0 0 0 0 0 1
1 1 0 1 0 p 0 0 p 0 0 p 0 0 1
2 0 0 0 0 0 0 0 0 0 0 0 0 0 1
2 0 0 0 0 0 0 0 0 0 0 0 0 0 1
1 1 0 1 0 p 0 0 p 0 0 p 0 0 1
1 0 0 1 0 0 0 0 0 0 0 0 0 0 1
1 0 0 1 0 0 0 0 0 1 1 0 0 0 1
1 1 3 1 1 1 4 4 1 1 1 1 1 1 1
door 2 GuardSpawn 9 5
door 3 Corridor 3 0
door 4 Corridor 7 0