Pool
12 15
1 0 0 0 0 3 3 0 0 0 0 1
1 0 0 0 0 0 0 0 0 0 0 1
1 0 0 - - - - - - 0 0 1
1 0 0 - - - - - - 0 0 1
1 0 0 - - - - - - 0 0 1
1 1 0 - - 0 0 - - 0 1 1
1 1 0 - - 0 0 - - 0 0 2
1 1 0 - - 0 0 - - 0 0 2
1 1 0 - - 0 0 - - 0 1 1
1 0 0 - - - - - - 0 0 1
1 0 0 - - - - - - 0 0 1
1 0 0 - - - - - - 0 0 1
1 0 0 0 0 0 0 0 0 0 0 1
1 0 0 0 0 0 0 0 0 0 0 1
1 1 1 1 1 1 1 1 1 1 1 1
door 2 SpySpawn 0 4
door 3 Courtyard 5 9