Room_1
10 10
1 1 1 1 2 2 1 1 1 1
1 0 0 0 0 0 0 0 0 1
1 0 0 0 0 0 0 0 0 1
1 0 0 1 1 1 1 0 0 1
1 0 0 0 - - 0 0 0 1
1 0 0 0 - - 0 K 0 1
1 0 0 1 1 1 1 0 0 1
1 0 0 0 0 0 0 0 0 1
1 0 0 0 0 0 0 0 0 1
1 1 1 1 3 3 1 1 1 1
door 2 Room_2 2 2
door 3 Room_3 4 4