SpySpawn
10 10
1 1 1 1 1 1 1 1 1 1
1 0 0 0 0 0 0 0 0 3
1 0 0 0 0 0 0 0 0 1
1 0 1 0 1 1 1 1 0 1
2 0 1 0 0 S S 1 0 4
2 0 1 0 0 S S 1 0 4
1 0 1 0 1 1 1 1 0 1
1 0 0 0 0 0 0 0 0 1
1 0 0 0 0 0 0 0 0 1
1 1 1 1 1 1 1 1 1 1
door 2 Pool 11 6
door 3 Corridor 0 1
door 4 Corridor 0 3